"filename", "language", "Python", "Markdown", "Properties", "toml", "comment", "blank", "total"
"/Users/fengming/Documents/GitHub/dsxindexer/README.md", "Markdown", 0, 41, 0, 0, 0, 3, 44
"/Users/fengming/Documents/GitHub/dsxindexer/pyproject.toml", "toml", 0, 0, 0, 17, 0, 1, 18
"/Users/fengming/Documents/GitHub/dsxindexer/setup.cfg", "Properties", 0, 0, 6, 0, 0, 3, 9
"/Users/fengming/Documents/GitHub/dsxindexer/setup.py", "Python", 21, 0, 0, 0, 3, 5, 29
"/Users/fengming/Documents/GitHub/dsxindexer/src/dsxindexer/configer.py", "Python", 62, 0, 0, 0, 35, 9, 106
"/Users/fengming/Documents/GitHub/dsxindexer/src/dsxindexer/factors/base_factor.py", "Python", 11, 0, 0, 0, 1, 3, 15
"/Users/fengming/Documents/GitHub/dsxindexer/src/dsxindexer/factors/float_factor.py", "Python", 8, 0, 0, 0, 2, 5, 15
"/Users/fengming/Documents/GitHub/dsxindexer/src/dsxindexer/factors/function_factor.py", "Python", 105, 0, 0, 0, 36, 9, 150
"/Users/fengming/Documents/GitHub/dsxindexer/src/dsxindexer/factors/int_factor.py", "Python", 8, 0, 0, 0, 2, 5, 15
"/Users/fengming/Documents/GitHub/dsxindexer/src/dsxindexer/factors/lparen_factor.py", "Python", 17, 0, 0, 0, 11, 6, 34
"/Users/fengming/Documents/GitHub/dsxindexer/src/dsxindexer/factors/newline_factor.py", "Python", 9, 0, 0, 0, 3, 4, 16
"/Users/fengming/Documents/GitHub/dsxindexer/src/dsxindexer/factors/string_factor.py", "Python", 8, 0, 0, 0, 2, 4, 14
"/Users/fengming/Documents/GitHub/dsxindexer/src/dsxindexer/factors/variable_factor.py", "Python", 25, 0, 0, 0, 11, 6, 42
"/Users/fengming/Documents/GitHub/dsxindexer/src/dsxindexer/functioner.py", "Python", 86, 0, 0, 0, 21, 20, 127
"/Users/fengming/Documents/GitHub/dsxindexer/src/dsxindexer/operators/andor_operator.py", "Python", 23, 0, 0, 0, 2, 3, 28
"/Users/fengming/Documents/GitHub/dsxindexer/src/dsxindexer/operators/base_operator.py", "Python", 12, 0, 0, 0, 1, 3, 16
"/Users/fengming/Documents/GitHub/dsxindexer/src/dsxindexer/operators/equal_operator.py", "Python", 26, 0, 0, 0, 9, 4, 39
"/Users/fengming/Documents/GitHub/dsxindexer/src/dsxindexer/operators/grealess_operator.py", "Python", 31, 0, 0, 0, 2, 3, 36
"/Users/fengming/Documents/GitHub/dsxindexer/src/dsxindexer/operators/greaterthen_operator.py", "Python", 18, 0, 0, 0, 4, 3, 25
"/Users/fengming/Documents/GitHub/dsxindexer/src/dsxindexer/operators/muldiv_operator.py", "Python", 29, 0, 0, 0, 2, 4, 35
"/Users/fengming/Documents/GitHub/dsxindexer/src/dsxindexer/operators/plusminus_operator.py", "Python", 30, 0, 0, 0, 2, 4, 36
"/Users/fengming/Documents/GitHub/dsxindexer/src/dsxindexer/parser.py", "Python", 49, 0, 0, 0, 35, 11, 95
"/Users/fengming/Documents/GitHub/dsxindexer/src/dsxindexer/processors/base_processor.py", "Python", 26, 0, 0, 0, 12, 10, 48
"/Users/fengming/Documents/GitHub/dsxindexer/src/dsxindexer/processors/factor_processor.py", "Python", 27, 0, 0, 0, 2, 5, 34
"/Users/fengming/Documents/GitHub/dsxindexer/src/dsxindexer/processors/operator_processor.py", "Python", 24, 0, 0, 0, 6, 5, 35
"/Users/fengming/Documents/GitHub/dsxindexer/src/dsxindexer/processors/sindexer_processor.py", "Python", 81, 0, 0, 0, 25, 14, 120
"/Users/fengming/Documents/GitHub/dsxindexer/src/dsxindexer/sindexer/BOLL.py", "Python", 10, 0, 0, 0, 18, 3, 31
"/Users/fengming/Documents/GitHub/dsxindexer/src/dsxindexer/sindexer/CCI.py", "Python", 10, 0, 0, 0, 17, 3, 30
"/Users/fengming/Documents/GitHub/dsxindexer/src/dsxindexer/sindexer/DMI.py", "Python", 10, 0, 0, 0, 14, 3, 27
"/Users/fengming/Documents/GitHub/dsxindexer/src/dsxindexer/sindexer/EMA.py", "Python", 18, 0, 0, 0, 15, 4, 37
"/Users/fengming/Documents/GitHub/dsxindexer/src/dsxindexer/sindexer/KDJ.py", "Python", 11, 0, 0, 0, 7, 3, 21
"/Users/fengming/Documents/GitHub/dsxindexer/src/dsxindexer/sindexer/MA.py", "Python", 17, 0, 0, 0, 5, 3, 25
"/Users/fengming/Documents/GitHub/dsxindexer/src/dsxindexer/sindexer/MACD.py", "Python", 13, 0, 0, 0, 6, 4, 23
"/Users/fengming/Documents/GitHub/dsxindexer/src/dsxindexer/sindexer/RSI.py", "Python", 10, 0, 0, 0, 10, 3, 23
"/Users/fengming/Documents/GitHub/dsxindexer/src/dsxindexer/sindexer/SMA.py", "Python", 14, 0, 0, 0, 12, 3, 29
"/Users/fengming/Documents/GitHub/dsxindexer/src/dsxindexer/sindexer/WR.py", "Python", 10, 0, 0, 0, 7, 3, 20
"/Users/fengming/Documents/GitHub/dsxindexer/src/dsxindexer/sindexer/base/cons_funcs.py", "Python", 5, 0, 0, 0, 27, 3, 35
"/Users/fengming/Documents/GitHub/dsxindexer/src/dsxindexer/sindexer/base/index_funcs.py", "Python", 18, 0, 0, 0, 44, 4, 66
"/Users/fengming/Documents/GitHub/dsxindexer/src/dsxindexer/sindexer/base/logical_funcs.py", "Python", 9, 0, 0, 0, 3, 1, 13
"/Users/fengming/Documents/GitHub/dsxindexer/src/dsxindexer/sindexer/base/math_funcs.py", "Python", 65, 0, 0, 0, 39, 10, 114
"/Users/fengming/Documents/GitHub/dsxindexer/src/dsxindexer/sindexer/base/price_funcs.py", "Python", 43, 0, 0, 0, 39, 1, 83
"/Users/fengming/Documents/GitHub/dsxindexer/src/dsxindexer/sindexer/base/refer_funcs.py", "Python", 39, 0, 0, 0, 62, 7, 108
"/Users/fengming/Documents/GitHub/dsxindexer/src/dsxindexer/sindexer/base_sindexer.py", "Python", 161, 0, 0, 0, 51, 36, 248
"/Users/fengming/Documents/GitHub/dsxindexer/src/dsxindexer/sindexer/fomulas.py", "Python", 27, 0, 0, 0, 49, 10, 86
"/Users/fengming/Documents/GitHub/dsxindexer/src/dsxindexer/sindexer/models/kline_model.py", "Python", 16, 0, 0, 0, 0, 1, 17
"/Users/fengming/Documents/GitHub/dsxindexer/src/dsxindexer/sindexer/sindexer_factory.py", "Python", 13, 0, 0, 0, 0, 4, 17
"/Users/fengming/Documents/GitHub/dsxindexer/src/dsxindexer/tokenizer.py", "Python", 211, 0, 0, 0, 57, 42, 310
"/Users/fengming/Documents/GitHub/dsxindexer/src/test.py", "Python", 62, 0, 0, 0, 32, 8, 102
"Total", "-", 1528, 41, 6, 17, 743, 311, 2646